{
  "map-15x15": {
    "name": "Twisted Paths",
    "difficulty": "Medium",
    "data": [
      [1, 1, 1, 1, 1, 1, 1, 1, 1, 1, 1, 1, 1, 1, 1],
      [1, 3, 1, 2, 2, 2, 2, 2, 2, 2, 2, 2, 1, 3, 1],
      [1, 2, 1, 2, 1, 2, 1, 2, 1, 2, 1, 2, 1, 2, 1],
      [1, 2, 2, 2, 2, 2, 1, 2, 1, 2, 2, 2, 2, 2, 1],
      [1, 1, 1, 2, 2, 2, 2, 2, 2, 2, 2, 2, 1, 2, 1],
      [1, 2, 2, 2, 0, 0, 0, 5, 0, 0, 0, 2, 2, 2, 1],
      [1, 2, 1, 1, 0, 1, 1, 0, 1, 1, 0, 1, 1, 2, 1],
      [1, 2, 2, 1, 0, 1, 6, 7, 8, 1, 0, 1, 2, 2, 1],
      [1, 2, 1, 1, 0, 1, 1, 1, 1, 1, 0, 1, 1, 2, 1],
      [1, 2, 2, 2, 0, 0, 0, 0, 0, 0, 0, 2, 2, 2, 1],
      [1, 1, 1, 2, 1, 1, 1, 1, 1, 1, 1, 2, 1, 1, 1],
      [1, 2, 2, 2, 2, 2, 2, 2, 2, 2, 2, 2, 2, 2, 1],
      [1, 2, 1, 2, 1, 2, 1, 4, 1, 2, 1, 2, 1, 2, 1],
      [1, 3, 2, 2, 1, 2, 2, 2, 2, 2, 1, 2, 2, 3, 1],
      [1, 1, 1, 1, 1, 1, 1, 1, 1, 1, 1, 1, 1, 1, 1]
    ]
  },
  "map-19x19": {
    "name": "Classic Maze",
    "difficulty": "Hard",
    "data": [
      [1, 1, 1, 1, 1, 1, 1, 1, 1, 1, 1, 1, 1, 1, 1, 1, 1, 1, 1],
      [1, 3, 2, 2, 2, 2, 2, 2, 2, 2, 2, 2, 2, 2, 2, 2, 2, 3, 1],
      [1, 2, 1, 1, 1, 2, 1, 1, 1, 1, 1, 1, 1, 2, 1, 1, 1, 2, 1],
      [1, 2, 1, 2, 2, 2, 2, 2, 2, 2, 2, 2, 2, 2, 2, 2, 1, 2, 1],
      [1, 2, 1, 2, 1, 1, 1, 2, 1, 1, 1, 2, 1, 1, 1, 2, 1, 2, 1],
      [1, 2, 2, 2, 2, 2, 1, 2, 2, 2, 2, 2, 1, 2, 2, 2, 2, 2, 1],
      [1, 2, 1, 1, 1, 2, 2, 2, 2, 2, 2, 2, 2, 2, 1, 1, 1, 2, 1],
      [1, 2, 2, 2, 2, 2, 0, 0, 0, 5, 0, 0, 0, 2, 2, 2, 2, 2, 1],
      [1, 1, 1, 1, 1, 2, 0, 1, 1, 0, 1, 1, 0, 2, 1, 1, 1, 1, 1],
      [1, 2, 2, 2, 2, 2, 0, 1, 6, 7, 8, 1, 0, 2, 2, 2, 2, 2, 1],
      [1, 2, 1, 1, 1, 2, 0, 1, 1, 1, 1, 1, 0, 2, 1, 1, 1, 2, 1],
      [1, 2, 2, 2, 1, 2, 0, 0, 0, 0, 0, 0, 0, 2, 1, 2, 2, 2, 1],
      [1, 2, 1, 2, 1, 2, 1, 1, 1, 1, 1, 1, 1, 2, 1, 2, 1, 2, 1],
      [1, 2, 1, 2, 2, 2, 2, 2, 2, 2, 2, 2, 2, 2, 2, 2, 1, 2, 1],
      [1, 2, 1, 1, 1, 1, 1, 2, 1, 4, 1, 2, 1, 1, 1, 1, 1, 2, 1],
      [1, 2, 2, 2, 2, 2, 2, 2, 2, 2, 2, 2, 2, 2, 2, 2, 2, 2, 1],
      [1, 2, 1, 1, 1, 2, 1, 1, 1, 1, 1, 1, 1, 2, 1, 1, 1, 2, 1],
      [1, 3, 2, 2, 2, 2, 2, 2, 2, 2, 2, 2, 2, 2, 2, 2, 2, 3, 1],
      [1, 1, 1, 1, 1, 1, 1, 1, 1, 1, 1, 1, 1, 1, 1, 1, 1, 1, 1]
    ]
  },
  "map-25x25": {
    "name": "Ultimate Gauntlet",
    "difficulty": "Expert",
    "data": [
      [
        1, 1, 1, 1, 1, 1, 1, 1, 1, 1, 1, 1, 1, 1, 1, 1, 1, 1, 1, 1, 1, 1, 1, 1,
        1
      ],
      [
        1, 3, 2, 2, 2, 2, 1, 2, 2, 2, 2, 2, 2, 2, 2, 2, 2, 2, 1, 2, 2, 2, 2, 3,
        1
      ],
      [
        1, 2, 1, 1, 1, 2, 1, 2, 1, 1, 1, 1, 1, 1, 1, 1, 1, 2, 1, 2, 1, 1, 1, 2,
        1
      ],
      [
        1, 2, 1, 2, 2, 2, 2, 2, 2, 2, 2, 2, 2, 2, 2, 2, 2, 2, 2, 2, 2, 2, 1, 2,
        1
      ],
      [
        1, 2, 1, 2, 1, 1, 1, 1, 1, 1, 1, 2, 1, 2, 1, 1, 1, 1, 1, 1, 1, 2, 1, 2,
        1
      ],
      [
        1, 2, 2, 2, 1, 2, 2, 2, 2, 2, 1, 2, 1, 2, 1, 2, 2, 2, 2, 2, 1, 2, 2, 2,
        1
      ],
      [
        1, 1, 1, 2, 1, 2, 1, 1, 1, 2, 1, 2, 1, 2, 1, 2, 1, 1, 1, 2, 1, 2, 1, 1,
        1
      ],
      [
        1, 2, 2, 2, 2, 2, 2, 2, 1, 2, 1, 2, 2, 2, 1, 2, 1, 2, 2, 2, 2, 2, 2, 2,
        1
      ],
      [
        1, 2, 1, 1, 1, 1, 1, 2, 1, 2, 1, 2, 2, 2, 1, 2, 1, 2, 1, 1, 1, 1, 1, 2,
        1
      ],
      [
        1, 2, 2, 2, 2, 2, 2, 2, 0, 0, 0, 0, 5, 0, 0, 0, 0, 2, 2, 2, 2, 2, 2, 2,
        1
      ],
      [
        1, 2, 1, 1, 1, 1, 1, 1, 0, 1, 1, 1, 0, 1, 1, 1, 0, 1, 1, 1, 1, 1, 1, 2,
        1
      ],
      [
        1, 2, 2, 2, 2, 2, 2, 2, 0, 1, 0, 0, 0, 0, 0, 1, 0, 2, 2, 2, 2, 2, 2, 2,
        1
      ],
      [
        1, 1, 1, 1, 2, 1, 1, 1, 0, 1, 0, 6, 7, 8, 0, 1, 0, 1, 1, 1, 2, 1, 1, 1,
        1
      ],
      [
        1, 2, 2, 2, 2, 2, 2, 2, 0, 1, 0, 0, 0, 0, 0, 1, 0, 2, 2, 2, 2, 2, 2, 2,
        1
      ],
      [
        1, 2, 1, 1, 1, 1, 1, 1, 0, 1, 1, 1, 1, 1, 1, 1, 0, 1, 1, 1, 1, 1, 1, 2,
        1
      ],
      [
        1, 2, 2, 2, 2, 2, 2, 2, 0, 0, 0, 0, 0, 0, 0, 0, 0, 2, 2, 2, 2, 2, 2, 2,
        1
      ],
      [
        1, 1, 1, 1, 2, 1, 1, 1, 1, 1, 1, 1, 1, 1, 1, 1, 1, 1, 1, 1, 2, 1, 1, 1,
        1
      ],
      [
        1, 2, 2, 2, 2, 2, 2, 2, 2, 2, 2, 2, 4, 2, 2, 2, 2, 2, 2, 2, 2, 2, 2, 2,
        1
      ],
      [
        1, 2, 1, 1, 1, 1, 1, 1, 1, 1, 2, 1, 1, 1, 2, 1, 1, 1, 1, 1, 1, 1, 1, 2,
        1
      ],
      [
        1, 2, 2, 2, 2, 2, 2, 2, 1, 2, 2, 2, 2, 2, 2, 2, 1, 2, 2, 2, 2, 2, 2, 2,
        1
      ],
      [
        1, 2, 1, 1, 1, 1, 1, 2, 1, 2, 1, 1, 1, 1, 1, 2, 1, 2, 1, 1, 1, 1, 1, 2,
        1
      ],
      [
        1, 2, 2, 2, 1, 2, 2, 2, 1, 2, 2, 2, 2, 2, 2, 2, 1, 2, 2, 2, 1, 2, 2, 2,
        1
      ],
      [
        1, 1, 1, 2, 1, 2, 1, 1, 1, 2, 1, 2, 1, 2, 1, 2, 1, 1, 1, 2, 1, 2, 1, 1,
        1
      ],
      [
        1, 3, 2, 2, 2, 2, 2, 2, 2, 2, 2, 2, 2, 2, 2, 2, 2, 2, 2, 2, 2, 2, 2, 3,
        1
      ],
      [
        1, 1, 1, 1, 1, 1, 1, 1, 1, 1, 1, 1, 1, 1, 1, 1, 1, 1, 1, 1, 1, 1, 1, 1,
        1
      ]
    ]
  }
}
